9 9
#_#_#_#_#_#_#_#_#_#
|#|#######|##_#_|#|
|#|_#_|#|#|#|#####|
|_##|###|#|#|#|#|_|
|#|#|###|#|_#_|###|
|##_|_|#|_#_#_|#|#|
|#|###|####_#_|_|#|
|#|#|######_##|###|
|_#_|_|_|_|_#_#_|_|